WWWWWWWWWWWWWWWWWWWWWWWWWW
W    S             S     W
W WWWWWWWWW WW WWWWWWWWW W
W WWWWWWWWW WW WWWWWWWWW W
W G G     G              W
WWWWWWWWWWWWWWWWWWWWWWWWWW